 #   #   #     #       #     
 ### ### # ####### # # ##### 
   #   #       #   # #   #   
 # # ##### ####### ### ### # 
 #   # #         # #   #   # 
 ### # ### # # ####### ### ##
   #   # # # #     #         
 ##### # # ######### ##### # 
     #         #   # #     # 
######## ### # # # ####### # 
   #   # # # #   #   #     # 
## # ### # ####### ####### ##
 #   # # # # #     # # #     
 # # # # # # ### ### # # ### 
   #       # # #   #       # 
 # # # ##### # ####### ### # 
 # # #                 #   # 
 # ### ####### ##### # ### # 
 # #   #         #   #   # # 
