     #     #           #     
 ####### ##### # # ### # # ##
   #     #   # # # #     # # 
 ####### ### ####### # ##### 
   # #             # # #   # 
## # ### # ### # ##### # ### 
         # #   #   # # #     
 # ########### # ### # ### ##
 # # #         #             
#### ### # ### ### # ### # # 
       # # #   #   #   # # # 
#### ### # ##### # ### ### # 
         #   # # # #   # # # 
 ####### ##### # # ### # ### 
 #   #   # #     # # # #     
 ### # ### ##### ### # ### ##
     #         #   #   # #   
## ### # ##### ### ### # # ##
     # # #     #     # #     
